Programme,Category,Male,Female,Others,Total
MPhil in Sports Science,GENERAL,1,1,0,2
,OBC,0,1,0,1
,SC,3,0,0,3
PhD in Sports Science,OBC,1,0,0,1
Diploma in Agriculture & Rural Development,OBC,5,4,0,9
,ST,4,4,0,8
"5 yr Intd. MSc in Agriculture, Rural & Tribal Development",GENERAL,6,3,0,9
,OBC,0,1,0,1
,SC,1,0,0,1
"PhD in Agriculture, Rural & Tribal Development",GENERAL,2,0,0,2
Intd. MPhil-PhD in Special Education,GENERAL,1,0,0,1
,UNKNOWN,1,0,0,1
Total,,25,14,0,39
